nightplains
10 1024
0.0 0.0 0.2
1.0 1.0 0.4
XX                                                                                                                                                                                  XXXXXX                                                                                                                                                                                                                                                                                                                                                                                                 XXXXXXXXXXXXXXXXX                                                                                                         
XXX                                                                 XXXXXXXXXXXXXXXXXXXXX                                                                     XXXXXXXXXXXXXXXXX     XXXXXX                                                        I        I       I                                                                                                                                                                                                                                                                                                                    XXXXXXXXXX
XXX                                                           XXX                      XXXXXXXXXXXXXXX                                                 XXXXXXXXXXXXXXXXXXXXXX       XXXXXX                                                 XXXXXXXXXXXXXXXXXXXXXXXXXXXXXXXXXX                                                                                                                                                     III                                                                                                                                                   XXXXXX
XXX                               XXXXXXXX                    XXX                                   S                                        XXXXXXXXXXXXXXXXXXXXXX                 XXXXXX                                        I                                                                                               I                                                                                           XXXXXXXXXXXXXXX                                                                                                                                      XXXXXXXXX
XXX                                                          XXXXX                               XXXXXXXXXXXXXX                      XXXXXXXXXXXXXXXXXXXXXXXXXX                     XXXXXX                                       XXXXXXXXX                           S          S                                                 XXXXXXXXX                                                                             XXXXXXXXXXXXXX                                                        I                                                                                XXXXXX              
XXX                XX           XXXXX  XXXX                                                      XXXXXXXXXXXXXXXX            XXXXXXXXXXXXXXXXXXXXXXXXX                              XXXXXX                                     I                                    XXXXXXXXXXXXXXXXXXXXXX                           I                                                                                             XXXXXXXXXXXXX                                                          XXXXXXXXXXXXXXXX                                                                 XXXXXX                                                                                                                                                                                          
XXX      XXXXXXXXXXX          XXXXXXXXXXXXXXX            XXXX     XXXXX                                                  XXXXXXXXXXXXXXXXXXX                                        XXXXXX                                   XXXXXXXXXXXXXXX                                                                     XXXXXXXXXXXXXXX                                                                              XXXXXXXXXXXXX                                                                                          S                                               XXXXXXXXXXX                                                                                                                                                                       
XXX      XXXXXXXXXXX S      XXXXXXXXXXXXXXXXXXX  S       XXXXXXXXXXXXXX        I    I         I     I     I            XXXXXXXXXXXXXX           XXXXXXXXXXXXXXXXXXXXXXXXXXXXXXXXXXXXXXXXXX                              XXXXXXXXXXXXXXXXXXX                                                                I                       S      S                          S               S    S     S        XXXXXXXXXXXXXXXXX                S  S  S                             XXXXXXXXXXXX     SS                   XXXXXXXXX            S          S      S        XXXXXXX                           
XXXXXXXXXXXXXXXXXXXXXXXXXXXXXXXXXXXXXXXXXXXXXXXXXXXXXXXXXXXXXXXXXXXXXXXXXXXXXXXXXXXXXXXXXXXXXXXXXXXXXXXXXXXXXXXXXXXXXXXXXXXXXXXXXXXXX  S                     S    I      S       I              S       SI          XXXXXXXXXXXXXXXXXXXXXXXXXXXXX               XXXXXXXXXXXXXXXXXXXXXXXXXXX   S           XXXXXXXXXX        XXXXXXXXXXXXXXXXXXXXXXX              XXXXXXXXXX     XXXXXXXXXXXXXXXXXXXXXXXXXXXXXXXXXXXXXXXXXXXXXXXXXXXXXXXXXXXXXXXXXXXXXXXXXXX          XXXXXX               XXXXXXXXXXXXXXXXXX      I    I   I       XXXXXXXXXXXXXXXXXXXXXXXXXXXXXXXXXXX                                                                                                                                                                                                                                                                                                                                                                                                                                                                                                                                                                        
XXXXXXXXXXXXXXXXXXXXXXXXXXXXXXXXXXXXXXXXXXXXXXXXXXXXXXXXXXXXXXXXXXXXXXXXXXXXXXXXXXXXXXXXXXXXXXXXXXXXXXXXXXXXXXXXXXXXXXXXXXXXXXXXXXXXXXXXXXXXXXXXXXXXXXXXXXXXXXXXXXXXXXXXXXXXXXXXXXXXXXXXXXXXXXXXXXXXXXXXXXXXXXXXXXXXXXXXXXXXXXXXXXXXXXXXXXXXXXXXX               XXXXXXXXXXXXXXXXXXXXXXXXXXXXXXXXXXXXXXXXXXXXXXXXXXXXXXXXXXXXXXXXXXXXXXXXXXXXXXXXXXXXXXXX   XXXXXXXXXXXXXXXXXXXXXXXXXXXXXXXXXXXXXXXXXXXXXXXXXXXXXXXXXXXXXXXXXXXXXXXXXXXXXXXXXXXXXXXXXXXXXXXXXXX   XXXXXXXXXX               XXXXXXXXXXXXXXXXXXXXXXXXXXXXXXXXXXXXXXXXXXXXXXXXXXXXXXXXXXXXXXXXXXXXXXXX                                                                                                                                                                                                                                                                                                                                                                                                                                                                                                                                                                        
