plains
10 1024
0.8 0.8 1.0
1.0 0.2 0.0 
                                                                                                                                                                                                                                                                                                                                                                                                                                                                                   S     S                                                                                                                                                            XXXXXXXXXX
XX                  XXX            XXX    XXX                                                      XXXX                                                                                                                                                                                                                                                                                                  XXX                                              I        S          XXXXXXXXXXXXXXXXX              S                                                                                                                                        XXXXXXXXXX
XX                  XXX      XX                                                              XXXX XXXXXX                                                                                                                                                                                                                                                                                                XXXXXXX                          S           XXXXXXXXXXXXXXXXXXXXXX                       XXXXXXXXXXXXXXXXXXXXXXXXXXXX                                                                                                                        XXXXXXXXXX
XXX                 XXX                        XX                                                   XXXXXX                                                                                                                                                                                                                                                                                             XXXXXXXX                        XXXXXXXXXX                            XXXXXXXXXXXX         XXXXXXXXXXXXXXXXXXXXXXXXXXXX        S     S       S                                                                                                 XXXXXXXXXX
XXX                 XXX         XX            XXX                                                      XXXXX                                                         S                 S                                                                                                         S         XXXXXX S     I        S                                                   XX               XXXXXXXXX                      XXXXXXXXXXXXXX                                                                              XXXXXXXXXXXXXXXXXXXXXXXXXXXXXXXX                                                                                     XXXXXXXXXX
XXX                 XXX                    XXXXXX             S              XXXX    S                 S     XXX S                                     XXXXXXXXXXXXXXXXXXXXXXXXXXXXXXXXXXXXXXXXXXXXXXXXXXXX                                                                                     XXXXXXXXXXXXXXXXXXXXXXXXXXXXXXXXXXXXXXXXXX                XX                       XXXX              XXXXXXXXXX                      XXXXX    XXXXX                                      XXXX                                    XXXXXXXXXXXXXXXXXXXXXXXXXXXXXXXX                                                                                     XXXXXXXXXX
XXXXXXXXXXXXX             XXXX     I    XXXXXXXXXXX          XXXXXX     XXXXXXXXXXXXXXXXXXXXX   XXXXXXXXXXXXXXXXXXXXXXX                                                                                                                          S                                       XXXXXXXXXXXXXXXXXXXXXXXXXXXXXXXXXXXXXXXXXXXXXXXXX               XXX                     XXXXXX             XXXXXXXXXXX          XXXX                                         XXXXXXXXXXXXXXXXX                                          XXXXXXXXXXXXXXXXXXXXXXXXXXXXXXXX                                                                                     XXXXXXXXXX
XXXXXXXXXXXXX      S      XXXX    XXXXXXXXXXXXXXXXXXXXX  XX  XXXXXXXXXXXXXXXXXXXXXXXXXXXXXXXX   XXXXXXXXXXXXXXXXXXXXXXX                                                                                     XXX         S             XXXXXXXXXXXXXXXXXXXXXXXXXXXXX    S          XXXXXXXXXXXXXXXXXXXXXXXXXXXXXXXXXXXXXXXXXXXXXXXXXXXXXXXX    S         XXXX     S   I         XXXXXXXX  SI        XXXXXXXXXXXX        XXXXXX                                    XXX                                                             XXXXXXXXXXXXXXXXXXXXXXXXXXXXXXXX                                                  S     S  S    SIIII    SI   S      XXXXXXXXXX
XXXXXXXXXXXXXXXXXXXXXXXXXXXXXXXXXXXXXXXXXXXXXXXXXXXXXXX  XX  I        XXXXXXXXXXXXXXXXXXXXXXX   XXXXXXXXXXXXXXXXXXXXXXXXXX  S           S              S              S                          XXXXXXXXXXXXXXXXXXXXXXXXXXXXXXXXXXXXXXXXXXXXXXXXXXXXXXXXXXXXXXXXXXXXXXXXXXXXXXXXXXXXXXXXXXXXXXXXXXXXXXXXXXXXXXXXXXXXXXXXXXXXXXXXXXXXXXXXXXXXXXXXXXXXXXXXXXXXXXXXXXXXXXXXXXXXXXXXXXXXXXXXXXXXXXXXXXXXXXXXXXXXXXXXXXXXXXXXXXXXXXXXXXXXXXXXXXXXXXXXXXXXXXXXXX  XX                                                                  XXXXXXXXXXXXXXXXXXXXXXXXXXXXXXXX                                       XXXXXXXXXXXXXXXXXXXXXXXXXXXXXXXXXXXXXXXXXXXXXXXXXXXXXXXX
XXXXXXXXXXXXXXXXXXXXXXXXXXXXXXXXXXXXXXXXXXXXXXXXXXXXXXX  XXXXXXXXXXXX XXXXXXXXXXXXXXXXXXXXXXX   XXXXXXXXXXXXXXXXXXXXXXXXXXXXXXXXXXXXXXXXXXXXXXXXXXXXXXXXXXXXXXXXXXXXXXXXXXXXXXXXXXXXXXXXXXXXXXXXXXXXXXXXXXXXXXXXXXXXXXXXXXXXXXXXXXXXXXXXXXXXXXXXXXXXXXXXXXXXXXXXXXXXXXXXXXXXXXXXXXXXXXXXXXXXXXXXXXXXXXXXXXXXXXXXXXXXXXXXXXXXXXXXXXXXXXXXXXXXXXXXXXXXXXXXXXXXXXXXXXXXXXXXXXXXXXXXXXXXXXXXXXXXXXXXXXXXXXXXXXXXXXXXXXXXXXXXXXXXXXXXXXXXXXXXXXXXXXXXXXXXXXXXXXX                                                                      XXXXXXXXXXXXXXXXXXXXXXXXXXXXXXXX     XXXXX  XX  XX  XXXX  XXX XX  XXXXXXXXXXXXXXXXXXXXXXXXXXXXXXXXXXXXXXXXXXXXXXXXXXXXXXXXXXXXX
