nightplains
10 1024
0.0 0.0 0.2
0.0 0.1 0.4 
XX                                                                                                                                                                                                                                                                                                                                                                                                                                                                X                                                                                                                                                                                                                                                                                                                                                                                                                                                                                                                                                                                     
XX                                                                                                                                                                                                                                                                                                                                                                                                               XXXXX                                    XXXX  XXX                                                                                                                                                                                                                                                               
XX                                                                                                                                                                                                                                                                                                                                                                                                              XXXX                                   XXX      XXX  
XX                                                                                                                                                                                                                                                                                                                                                                                                             XXX                                  XXX         XXX                             
XXXX                                                                                                                                                                                                                                                                                                                                                                                                     XX                                     XXXXX           XXX           
XXXX                                                                               S                S                                                                                                                                                                                                                                                                                               XXXXX                  XXXXXXXX     XXXXXXX                 XXX  
XXXX                                                   S           XXXXXXXXXXXXXXXXXXXXXXXXXXXXXXXXXXXXXXXXXXXXXXXXX                                                                                                                                                                                                                                                                          XXXXXXXXXXX                                                 XXX    
XXXX       S       S            S      XXXXXXXXXXXXXXXXXXXXXXXXXXXXXXXXXXXXXXXXXXXXXXXXXXXXXXXXXXXXXXXXXXXXXXXXXXXXXXXX                                                           XXXXXXXXXXXXXXXXXXXXXXXXXXXXXXXXXXXXXXXXXXXXXXXXXXXXXXXX                                                                                            XXXXXXXXXXXXXXXXXXXXXXXXXXXXXXXXXXXXXXXXXXXXXXXXXXXX                                                         XXXX             XXXXXXXXX                  
XXXXXXXXXXXXXXXXXXXXXXXXXXXXXXXXXXXXXXXXXXXXXXXXXXXXXXXXXXXXXXXXXXXXXXXXXXXXXXXXXXXXXXXXXXXXXXXXXXXXXXXXXXXXXXXXXXXXXXXXXXXX                                                    XXXXXXXXXXXXXXXXXXXXXXXXXXXXXXXXXXXXXXXXXXXXXXXXXXXXXXXXXXXXXXXXXXXXXXXXXXXXXXXXXXXXXXXXXXXXXXXXXXXXXXXXXXXXXXXXXXXXXXXXXXXXX             XXXXXXXXXXXXXXXXXXXXXXXXXXXXXXXXXXXXXXXXXXXXXXXXXXXX                                                                           XXX     XXX  
XXXXXXXXXXXXXXXXXXXXXXXXXXXXXXXXXXXXXXXXXXXXXXXXXXXXXXXXXXXXXXXXXXXXXXXXXXXXXXXXXXXXXXXXXXXXXXXXXXXXXXXXXXXXXXXXXXXXXXXXXXXXXXXXXXXXXXXXXXXXXXXXXXXXXXXXXXXXXXXXXXXXXXXXXXXXXXXXXXXXXXXXXXXXXXXXXXXXXXXXXXXXXXXXXXXXXXXXXXXXXXXXXXXXXXXXXXXXXXXXXXXXXXXXXXXXXXXXXXXXXXXXXXXXXXXXXXXXXXXXXXXXXXXXXXXXXXXXXXXXXXXXXXXXXXXXXXXXXXXXXXXXXXXXXXXXXXXXXXXXXXXXXXXXXXXXXXXXXXXXXX
