plains
10 1024
0.5 0.6 0.9
1.0 1.0 0.4 
X                                                                                                                                                                                                                                                I             I               I                                                                                                                                                                                                                                                                              I
X                                                                                                                                                                                                                                 XXXXXXXXXXXXXXXXXXXXXXXXXXXXXXXXXXXXXXXXXXXXXXXXXXXXXX                                                                                                                                                                                                                                                                     XXXXXXX   XX                                                XX
X                                                                                                                                                                                                                             XX                                                                                                                                                                                                                                                                                                                        XXX            XX                                                XX
X                                                                                                                                                                                                                          XXXXX                                                                                                                                                                                                                                                                                                                                       XX                                                XX
X                                                                                                                                                                                                                        XXXXXXX                                                                                                                                                                                                                                                                                                                     XXX               XX                                                XX
X                                                                                                                                                                                                       S       XXXXXXX                                                                                                                                                                                                                                                                                                                                   XXX          XX                                                XX
X                                                                                                                                                                                                       XXXXXX                                                                                                                                                                                                                                              S       S             S                                        S                                    XX     XX                                                XX
X                                                   S    S              S         S                                         S             S                                           S        XXXXXX                                                                                            S                      S                                                                                                             S    S           XXXXXXXXXXXXXXXXXXXXX  XXXXXXXXXXX XXX  XX  XX XXX XXX XX XX  XXXXXXXXXXXXXXXX                             XX   XX      S                                         XX
X             S       S    S       S      S    XXXXXXXXXXXXXXXXX    XXXXXXXXXXXXXXXXXXXX       I        I     XXXXXXXXXXXXXXXXXXXXXXXXXXXXXXXXXXXXXXXXX                               XXXXXX                                                                                            XXXXXXXXXXXXXXXXXXXXXXXXXXXXXXXXXXXXXXXXXXXXX            I  S  I                                                                      XXXXXXXXXXXXXXXXXXXXXX                                                                                    XXXXXXXXXXXXXX        S        XX      XXXXXX          IIIIIIII                  XX
XXXXXXXXXXXXXXXXXXXXXXXXXXXXXXXXXXXXXXXXXXXXXXXXXXXXXXXXXXXXXXXXXXXXXXXXXXXXXXXXXXXXXXXXXXXXXXXXXXXXXXXXXXXXXXXXXXXXXXXXXXXXXXXXXXXXXXXXXXXXXXXXXXXXXXXXXXX  XXXXXX  XXXXXX   XXXXXX                                                                                                                                                   XXXXXXXXXXXXXXXXXXXXXXXXXX  XXXXXXX  XXXXXXXX  XXX XX XXXXXXXXXXXXXXXXX  XXXXXXXXXXXX                                                                                                                               XXXXXXXXXXXXXX      XXXXXXXXXXXXXXXXXXXXXXXXXXXXXXXXXXXXXXXXXXXX
